===招待状===
拝啓		はいけい		Dear (so and so)
半世紀		はんせいき	half century
勝手ながら
就きましては	つきましては	in line with this; therefore
見会を行いたいと思います。
察する		さっする		1:  to guess; to sense; to presume; to judge;2
===１===
にべもなく
意地を張る	いじをはる	to not give in; to be obstinate; to be stubbor
次第に		しだいに		1:  gradually (progress into a state);2:  in s
疎遠		そえん		estrangement; neglect; silence
儀式		ぎしき		ceremony; rite; ritual; service
勤務先		きんむさき	place of employment
合弁		ごうべん		joint management; pool
家庭円満		かていえんまん	family happiness; household harmony
証拠		しょうこ		evidence; proof
保障		ほしょう		guarantee; security; assurance; pledge; warran
要件		ようけん		1:  important matter;2:  requirement; requisit
目を奪われる	めをうばわれる	to be captivated (visually)
望みを叶える
唐突		とうとつ		abrupt; sudden
好景気		こうけいき	good times; boom; (wave of) prosperity
都心		としん		city centre (center) (esp. capital city); urba
家庭崩壊
景気		けいき		condition; state; business (condition)
頭を下げる	あたまをさげる	to bow one's head
半ば		なかば		middle; half; semi; halfway; partly
購入		こうにゅう	purchase; buy
昇進		しょうしん	promotion
致命傷		ちめいしょう	fatal wound
転勤		てんきん		job transfer; job relocation; intra-company tr
身を乗り出す	みをのりだす	to bend oneself forward (esp. in curiosity or 
知らん顔		しらんかお	unconcerned air; indifference; feigned ignoran
迫る		せまる		1:  to approach; to draw near; to be imminent;
故郷		こきょう		home town; birthplace; old village; historic v
立ち寄る		たちよる		to stop by; to drop in for a short visit
目と鼻の先	めとはなのさき	in front of your eyes; right next to you
迷惑をかける	めいわくをかける	to cause trouble (for someone); to annoy; to b
近況		きんきょう	recent state; present state; present condition
愚痴		ぐち		1:  idle complaint; grumble;  <span class="tag
縁を切る		えんをきる	to get a divorce; to sever connections
中堅		ちゅうけん	1:  main body (of troops);2:  center field; ce
身寄り		みより		relative
藁にもすがる
ありありと
繁華街		はんかがい	business district; shopping district; bustling
当り前		あたりまえ	1:  natural; reasonable; obvious;2:  usual; co
途方にくれる	とほうにくれる	to be at a loss; to be puzzled
===２===
似顔絵		にがおえ		portrait; likeness
封切館
支離滅裂		しりめつれつ	incoherent; inconsistent; illogical; disorderl
うんざりする
記憶		きおく		1:  memory; recollection; remembrance;2:  stor
苦労		くろう		troubles; hardships
一回り		ひとまわり	1:  one turn; one round;2:  (a) size;  <span c
気を遣う		きをつかう	to pay attention to another's needs; to attend
胸がときめく
燥ぐ		はしゃぐ		to make merry; to frolic; to be in high spirit
先代		せんだい		family predecessor; previous age; previous gen
沈黙		ちんもく		silence; reticence
問いただす	といただす	to enquire of someone about something (inquire
不倫		ふりん		adultery; immorality; impropriety
踏み切る		ふみきる		to make a bold start; to take a plunge; to tak
弁える		わきまえる	to know (right from wrong); to discern; to dis
怒り		いかり		anger; hatred; rage; wrath
嫉妬		しっと		jealousy; envy
穏やか		おだやか		calm; gentle; quiet
表情		ひょうじょう	facial expression
事情		じじょう		circumstances; consideration; conditions; situ
口を挟む		くちをはさむ	to cut into (a conversation); to interject
飯事		ままごと		playing house
復讐		ふくしゅう	revenge
見栄を張る	みえをはる	to be pretentious; to put on airs
説教		せっきょう	propound; preach; sermon
地位		ちい		(social) position; status
資格		しかく		qualifications; requirements; capabilities
如何にも		いかにも		indeed; really; phrase meaning agreement
緊張		きんちょう	tension; mental strain; nervousness
===３===
妙		みょう		strange
由来		ゆらい		origin; source; history; derivation; reason; d
生産地		せいさんち	producing area
栄える		はえる		to shine; to look attractive; to look pretty
範囲		はんい		extent; scope; sphere; range; span
佇む		たたずむ		to stand (still) a while; to loiter; to stop
繁栄		はんえい		prospering; prosperity; thriving; flourishing
建設会社		けんせつがいしゃ	construction company
別居生活
勝手		かって		1:  one's own convenience; one's way;2:  conve
感傷的		かんしょうてき	sentimental
意地		いじ		disposition; spirit; willpower; obstinacy; bac
見栄		みえ		show; display; appearance; vanity; charm; attr
無責任		むせきにん	irresponsibility
===４===
老いる		おいる		to age; to grow old
技術的		ぎじゅつてき	technical; practical
程度		ていど		degree; amount; grade; standard; of the order 
使い途
取敢えず		とりあえず	at once; first of all; for the time being; for
放っておく	ほっておく	to leave alone; to leave as is; to ignore; to 
寧		むしろ		rather; better; instead
手放す		てばなす		to release; to relinquish; to sell; to part wi
感心		かんしん		admiration; Well done!
あわただしく
開演		かいえん		curtain raising; starting (e.g. play, concert)
当たり前		あたりまえ	1:  natural; reasonable; obvious;2:  usual; co
偶然		ぐうぜん		(by) chance; unexpectedly; suddenly; accident;
歩み寄る		あゆみよる	to step up; to compromise; to meet halfway
自信		じしん		self-confidence
風采		ふうさい		appearance; air; mien; getup
佇い		たたずまい	appearance; shape; figure; bearing
抜け出る		ぬけでる		to excel; to steal out
幼なじみ		おさななじみ	childhood friend; friend from infancy; old pla
そっくりそのまま
口にする		くちにする	1:  to taste; to eat;2:  to speak of; to refer
きょとんとする
饒舌		じょうぜつ	garrulity; loquacity; talkativeness
介抱		かいほう		nursing; looking after
奇遇		きぐう		unexpected meeting
経緯		けいい		1:  details; whole story; sequence of events; 
悠々自適		ゆうゆうじてき	living a life of leisure with dignity; living 
冥利につきる	みょうりにつきる	to get more blessing than one deserves
封切		ふうきり		premiere; first showing; release (film)
憧れ		あこがれ		yearning; longing; aspiration
俯く		うつむく		to hang one's head in shame; to look downward;
===５===
死角		しかく		blind spot; dead space
ぎっしりと
この上なく	このうえなく	most of all; extremely
満ちる		みちる		1:  to be full;2:  to wax (e.g. moon);3:  to r
呟く		つぶやく		to mutter; to murmur
咳払い		せきばらい	clearing one's throat; cough
気をつけ
肝心		かんじん		essential; fundamental; crucial; vital; main
連れ合い		つれあい		one's husband; one's wife
伝統		でんとう		tradition; convention
世間		せけん		world; society
顔向け		かおむけ		face another
食いしばる
監督		かんとく		1:  supervision; control; superintendence; dir
上映時間		じょうえいじかん	running time (e.g. of movie)
心がこもる	こころがこもる	to be thoughtful (of a gift, etc.); to be from
拍手		はくしゅ		clapping hands; applause
微笑む		ほほえむ		to smile
通夜		つや		all-night vigil over a body; wake
生涯		しょうがい	one's lifetime (i.e. one's existence until dea
贅沢		ぜいたく		1:  luxury; extravagance;  <span class="tags m
しみじみと
天才		てんさい		genius; prodigy; natural gift
Thank you, jisho.org! :)
